  0        0        0        0
0 0      0 0      0 1      0 1
0 0      1 0      0 0      1 0

                  R+1      R+1      



  1        1        1        1
0 0      0 0      0 1      0 1
0 0      1 0      0 0      1 0

R+1      R+1      L+1      L-1
                           C+1


  0        0        0        0
1 0      1 0      1 1      1 1
0 1      1 1      0 1      1 1

L+1      L-1      R-1      R-1
         C+1      C+1      C+1



  1        1        1        1
1 0      1 0      1 1      1 1
0 1      1 1      0 1      1 1

R-1      R-1      C+1      C+1
C+1      C+1      
                  